#########
#       #
#@$ $ $ #
#### #  #
#  #$#$##
# ...  #
# ..*# #
##     #
 #######
