 ####
 #  ##
##$  #
# $$ ##
# #.  #
# @.. #
#######
