   #####
 ###   #
 #   $ #
##$..$##
# $.. #
# @ ###
#####
