 #####
## . #
#  * #
# $* #
#  * #
###@ #
  ####
