######
#    #
# #$ #
# .$.#
#  @ #
######
