########
#      #
# $$   #
##@##  #
 #$ #$##
 #.... #
 #     #
 #######
