#######
#     #
#   $$#
# ##  ##
#  #$  #
##.#   #
# .##$##
# .    #
# . @  #
########
