 #####
##.. #
# $. #
# $. #
# $$ #
# @###
####
