#########
#   #   #
#   .   #
## #*####
#   * $ #
#   * @ #
#########
