      ####
 ######  #
 #       #
 # ####  #
##$$  # ##
# $... * #
# @ ##   #
##########
