 #####
 #   #
 # # #
##*..#
# $ ##
# $  #
# @  #
######
