    ####
#####  ###
# $ $ $$ #
# # #..# #
# @  ..  #
##########
