########
#  . . #
# .#.# #
# $$$$ #
##    ##
 ###@ #
   ####
