 #####
 #   #####
 # # ..  #
 # # ..  #
##$#$## ##
# $ $   #
# @ #   #
#########
