####
#  #####
#      #
# .#.# #
##$$$$ #
# . .###
# @  #
######
