##########
#        #
# ###### #
# #    # ##
# #    #  #
#  .****$ #
#### @ #  #
   ########
