########
#  #   #
#  #...#
# $$$$$#
#  #.*.#
#  #   #
#  @  ##
#######
