     #####
######   #
#   #  . #
# $ # $.##
##   $$.#
 #  ##@.#
 #  #####
 ####
