 #########
 #       #
 #.##### #
 #.    # #
##.##$$$ #
#  ##  ###
#     @#
#  #####
####
