########
#  . . #
#  $ $ #
#####*@#
#  $ $ #
#  . . #
########
