######
#.  .#
# $$ #
#.$@##
# $$ #
#.  .#
######
