 #######
 #     #
 #.##  ##
## ## $ #
# $  $$ #
# ... # #
#  #### #
# @     #
#########
