   ####
####  #####
#  .*.#@  #
#  .# $$# #
## ## #   #
 #    $  ##
 #  #   ##
 ########
