########
#  #   #
#      #
#  ## ###
## ##$$ #
## ## #@#
# . .$. #
#   #####
#####
