#######
#   # #
# $ * #
##* . #
# *  ##
# @   #
#######
