######
#    #
# ##$###
# # $  #
# ..*. #
##  $  #
 #@# ###
 #   #
 #####
