   ####
   #  #
   # .###
   #$.  #
#### .$ #
#  $$.###
#   @ #
#######
