#####
#   #
# $ #
#@$$##
##$..#
 # ..#
 #   #
 #####
