 ####
##  #
# * ##
# *$ #
# .  #
# # ##
# @ #
#####
