#######
#     #
# .$$ #
##. ###
# .$$ #
# . # #
#   @ #
#######
