########
#  #   #
#. ..  #
#$$### ##
# $     #
#   # @ #
#########
