 ####
 #  ###
 #$.  #
 # .# #
##$.  #
# $ ###
# @ #
#####
