 ####
 #  ##
## $ #
# .*.##
# #$  #
#  @  #
#######
