#######
#. .  #
#. *  #
## # ##
# $$$ #
#  @  #
#######
