   ####
 ###  #
 #.   #
 #  * #
### ###
#   @ #
#   $ #
#  ####
####
