 #######
 #  .  #
 # #.  #
##$## ##
# $   #
#   @ #
#######
