#######
#...  #
# $@$ ##
## ##  #
 #  $  #
 #  #  #
 #######
