 ######
 #    #
 # #$$##
 #     #
##$### #
#  # . #
#    . #
###  + #
  ######
