######
#    ##
#  $  #
##$$$ #
 # #  #
 # ## ##
 # $...#
 #  . .#
 # @####
 ####
