#####
#   ####
#      #
# $ $$@#
##$##  #
 # #####
##.. #
# .. #
#    #
######
