 #####
 #   ##
 #$$@ #
## ## ##
#  #.  #
#      #
####. ##
   ####
