    ####
#####  #
#   #  #
# $ @  #
## ###.##
 #$$ #. #
 #    . #
 #####  #
     ####
