  #####
  #   #
### #$##
#  $ $ #
#... @ #
########
