 #######
##  #  ###
#   $$@$ #
#  # ... #
#  #  #  #
##########
