    #####
#####@  #
#   $$$ #
#..**. ##
#      #
########
