######
#.   #
#.   #
## . #
#  ###
# $$ #
#  $ #
#  @ #
######
