    ######
#####  . #
# $  **. #
# $      #
# @#######
####
