  #####
###  .#
#   # #
#@$$$.#
#   # #
#  ## #
#    .#
#######
