 ########
 #      #
 #  $ $ #
### ##.##
# *  #.#
# *  #.#
#@*  # #
## ### ##
#     $ #
#   #   #
#########
