########
#   #  #
#. ..$ ##
##$##$  #
#       #
# @ #####
#####
