  #######
###     #
#   $ $ #
# ##$#####
# #.$.   #
# #.@.   #
# ###### #
#        #
##########
