#######
#  $. #
#  $. #
###  ###
 # $.  #
 #@$.  #
 #######
