#######
#     #
# *** #
# *+* ##
# ***  #
#    $ #
####   #
   #####
