#########
#  ..#  #
# #..$  #
#  $ #  #
##  ## ##
 # $@$  #
 ####   #
    #####
