 #########
 #  ##   #
##   $$$ #
#. .#$@$ #
#...#    #
#   ######
#   #
#####
