#######
#     #
# $ $ #
# ### #
# ..#$##
##.. $ #
 #   # #
 #   @ #
 #######
