  #####
###   ##
#   $  #
# ##$#.#
# # @ .#
# #$##.#
#  $ #.##
##      #
 ####   #
    #####
