   ####
####@ #
#  $$$##
# ##   #
# ## # #
#  ... #
#   ####
#####
