  ####
###  ####
#       #
#  $$#  #
## #@$ ##
#  ### #
#  ... #
########
