 ####
 #  #
##. ###
# .$$ #
# .@# #
# .$$ #
##    #
 ######
