####   #####
#  #####   #
# $$       #
#  ###### ##
## #    # #
 # #    # #
## ## #.  #
# $   #. ##
#   # @. #
##########
