  ####
 ##  ####
 # ...  #
 #   .# #
##$#$## #
# $ $ @ #
#     ###
#######
