####
#  #
# $#####
#      #
#.$.$. #
#  # @ #
########
