        ####
#########  #
#   ## $   #
#  $   ##  #
### #...# ##
  # #.$.#$##
  # #.$ #  #
  #   $    #
  # @#######
  ####
