  #######
  #  .  #
 ###$#  #
 #  . . #
###$#$ ##
#  . . .#
# $#$#$ #
#  @ #  #
#########
