 ########
 #      #
 #$.*.$ #
## * * ##
# $.*.$#
#   @  #
########
