#####
#   ####
#.$ #  #
#.$  $.#
#.$# $.#
#  # @ #
########
