 ######
 #    #
 # ##$####
 # # $   #
 # # @ $ #
## #$## ##
# ..    #
# ..#   #
#########
