  #####
  #  .##
###.$. #
#  $$# #
#   @  #
########
