   #####
   #   #
####$  #
#   $ ##
# # #  #
# @ . .#
########
