 #########
 #       #
 # ##### #
##$#...# #
# $  $$  #
#   #.@  #
##########
