########
#  #   #
#.. .  #
#.. ## #
### ##$##
# $$$ $ #
#   @   #
#########
