######
#    #
#$$$ #
#....#
# $$.#
#  @ #
######
