#######
#     ##
# *$*$ #
# #  # #
# . .@ #
########
