 ########
 #      #
 #$## # #
 #. # $ #
##..# ###
#     $ #
# @ #   #
#########
