#######
#  #  #
#     #
#     #
#### ##
#  @  #
# $**.#
#  #  #
#######
