  #####
  #   #
  #*# #
  #   #
###*#.####
#        #
#   #*$# #
##### @  #
    ######
