##########
#  #  ...#
# $$$#@  #
#    ## ##
###     #
  ####  #
     ####
