#######
#     #
# # # #
# $.# #
##$ . #
 #@* ##
 ##  #
  ####
