     ####
######  #
#   ##@ #
#    #$.#
##    $.#
 ##  #$.#
  ####  #
     ####
