#########
#   @   #
# $ $ $ #
##.#.#.##
# $ $ $ #
# . . . #
#########
