     #####
###### . #
#   ##$. #
#@$$$  . #
##  #  . #
 #  ######
 ####
