#######
#     #
# * * #
##. $##
# * * #
#     #
# @#  #
#######
