  #########
### @ #   #
# * * * . #
#   $ #   #
####*## ###
 #       #
 #   #   #
 #########
