 ######
 #    #
##... #
# $$$ #
#@  ###
#####
