 #####
 # . ##
 # .  #
 # .  #
## # ##
# $$$#
#  @ #
######
