########
#  ##  ###
#   ..   #
#  $#.$$ #
###  .$@##
  #######
