######
#    #
#. $ #
#.#$##
#    #
#  @ #
######
