###############
# $. . . . .  #
# # $ $ $ $ @ #
# ########## ##
#            #
##############
