 #######
 #     #
 #$### #
 #  .. #
 # #.. #
##$## ##
# $ $ #
#   @ #
#######
