 #######
 #     #
 # ### #
 #. $  #
##.#$###
# . $  #
#   @# #
### ## #
  #    #
  ######
