#######
#  #  #
# *   #
#  #  #
## # #########
 # #     #   #
 # ## ##   $ #
 # #  #  ## ##
 # #$ #  .# #
 # #  # ..# #
 # #$###### #
 #      @   #
 #########  #
         ####
