  ####
 ##@ #
## * #
#  $ #
#  . #
######
