#########
#  ...  #
#  # #  #
# $$@$  #
#  ###  #
#### ####
